11111111
1P000011
1C000011
1E000001
100100C1
10000001
10000001
11111111