1111111111111111111
111111P011111111111
1111110011111111111
1000C00000C00000001
100000CC0000CCC0001
1C0C00000000CC00001
1000011111100000001
1111111111111000111
1111111111111E11111
1111111111111111111
