1111111111111111111
11P0000000000000011
1111111111100111111
1111110011100111111
11111000C11CC111111
11110C0111100111111
1000000CCC000000001
1111111111111000111
1E00000000000000001
1111111111111111111
